{
	"name":"Choke-point Island",
	"desc":"Island with a single choke-point.",
	"r":66,
	"g":129,
	"b":237,
	"spawnX1":8,
	"spawnX2":4,
	"spawnY1":2,
	"spawnY2":15,
	"data":[
			
			[1, 1, 1, 1, 1, 1, 1, 1, 1, 1, 1, 1, 1],
			[1, 1, 1, d, d, d, d, e, d, d, 1, 1, 1],
			[1, 1, d, 0, 0, 3, 0, 0, 7, 0, d, 1, 1],
			[1, 1, d, d, 0, 0, 0, 2, 0, e, d, 1, 1],
			[1, 1, 1, 1, d, d, 0, d, d, 1, 1, 1, 1],
			[1, 1, 1, 1, 1, d, 6, d, 1, 1, 1, 1, 1],
			[1, 1, 1, 1, 1, e, 0, d, 1, 1, 1, 1, 1],
			[1, 1, 1, 1, 1, d, 5, 7, d, 1, 1, 1, 1],
			[1, 1, 1, 1, d, 0, 0, 0, d, 1, 1, 1, 1],
			[1, 1, 1, 1, d, 7, 0, d, d, 1, 1, 1, 1],
			[1, 1, 1, 1, d, d, 5, e, 1, 1, 1, 1, 1],
			[1, 1, 1, 1, 1, d, 0, d, 1, 1, 1, 1, 1],
			[1, 1, 1, 1, 1, d, 6, d, 1, 1, 1, 1, 1],
			[1, 1, 1, d, e, 2, 0, 0, d, d, 1, 1, 1],
			[1, 1, d, 0, 0, 0, 0, 3, 0, 0, d, 1, 1],
			[1, 1, d, d, 7, e, 0, d, 0, d, d, 1, 1],
			[1, 1, 1, 1, d, 1, d, 1, d, 1, 1, 1, 1],
			[1, 1, 1, 1, 1, 1, 1, 1, 1, 1, 1, 1, 1]
			]
}