{
	"name":"GrassLands",
	"desc":"A basic map with some grass and water.",
	"spawnX1":1,
	"spawnX2":9,
	"spawnY1":0,
	"spawnY2":13,
	"data":[
			[0, 0, 0, 0, 0, 0, 6, 0, 0, 0, 7],
			[0, 0, 0, 0, 0, 0, 0, 0, 0, 0, 0],
			[0, 0, 7, 0, 2, 1, 1, 1, 1, 0, 0],
			[0, 0, 0, 0, 0, 0, 0, 0, 0, 1, 1],
			[0, 0, 0, 0, 0, 3, 0, 0, 0, 0, 0],
			[0, 0, 0, 6, 0, 1, 2, 7, 0, 0, 0],
			[0, 0, 0, 0, 1, 1, 1, 0, 5, 0, 0],
			[0, 0, 5, 0, 1, 1, 1, 0, 0, 0, 0],
			[0, 0, 0, 2, 2, 3, 0, 6, 0, 0, 0],
			[0, 0, 0, 0, 0, 0, 0, 0, 0, 0, 0],
			[1, 1, 1, 0, 0, 0, 0, 0, 0, 0, 0],
			[0, 0, 0, 1, 1, 1, 2, 0, 7, 0, 0],
			[0, 0, 0, 0, 0, 0, 0, 0, 0, 0, 0],
			[7, 0, 0, 0, 6, 0, 0, 0, 0, 0, 0]
			]
}