{
	"name":"GrassLands",
	"desc":"A basic map with some grass and water.",
	"r":66,
	"g":129,
	"b":237,
	"spawnX1":2,
	"spawnX2":10,
	"spawnY1":1,
	"spawnY2":14,
	"data":[
			[d, d, d, d, d, d, d, d, d, d, d, d, d],
			[d, 0, 0, 0, 0, 0, 0, 6, 0, 0, 0, 7, d],
			[d, 0, 0, 0, 0, 0, 0, 0, 0, 0, 0, 0, d],
			[d, 0, 0, 7, 0, 2, 1, 1, 1, 0, 0, 0, d],
			[d, 0, 0, 0, 0, 0, 0, 0, 0, 0, 1, 1, 1],
			[d, 0, 0, 0, 0, 0, 3, 0, 0, 0, 0, 0, d],
			[d, 0, 0, 0, 6, 0, 1, 2, 7, 0, 0, 0, d],
			[d, 0, 0, 0, 0, 1, 1, 1, 0, 5, 0, 0, d],
			[d, 0, 0, 5, 0, 1, 1, 1, 0, 0, 0, 0, d],
			[d, 0, 0, 0, 2, 2, 3, 0, 6, 0, 0, 0, d],
			[d, 0, 0, 0, 0, 0, 0, 0, 0, 0, 0, 0, d],
			[1, 1, 1, 0, 0, 0, 0, 0, 0, 0, 0, 0, d],
			[d, 0, 0, 0, 1, 1, 1, 2, 0, 7, 0, 0, d],
			[d, 0, 0, 0, 0, 0, 0, 0, 0, 0, 0, 0, d],
			[d, 7, 0, 0, 0, 6, 0, 0, 0, 0, 0, 0, d],
			[d, d, d, d, d, d, d, d, d, d, d, d, d]
			]
}