{
	"name":"Hell",
	"desc":"There's a highway to this apparently...",
	"spawnX1":1,
	"spawnX2":9,
	"spawnY1":0,
	"spawnY2":13,
	"data":[
			[8, 8, 8, 8, 8, 8, 10, 8, 8, 8, 10],
			[8, 8, 8, 8, 8, 8, 8, 8, 8, 8, 8],
			[8, 8, 10, 8, 12, 4, 4, 4, 4, 8, 8],
			[8, 8, 8, 8, 8, 8, 8, 8, 8, 4, 4],
			[8, 8, 8, 8, 8, 11, 8, 8, 8, 8, 8],
			[8, 8, 8, 10, 8, 4, 12, 10, 8, 8, 8],
			[8, 8, 8, 8, 4, 4, 4, 8, 9, 8, 8],
			[8, 8, 9, 8, 4, 4, 4, 8, 8, 8, 8],
			[8, 8, 8, 12, 12, 11, 8, 10, 8, 8, 8],
			[8, 8, 8, 8, 8, 8, 8, 8, 8, 8, 8],
			[4, 4, 4, 8, 8, 8, 8, 8, 8, 8, 8],
			[8, 8, 8, 4, 4, 4, 12, 8, 10, 8, 8],
			[8, 8, 8, 8, 8, 8, 8, 8, 8, 8, 8],
			[10, 8, 8, 8, 10, 8, 8, 8, 8, 8, 8]
			]
}