{
	"name":"Lava Lake",
	"desc":"Hell world with a lake of lava.",
	"r":81,
	"g":24,
	"b":24,
	"spawnX1":6,
	"spawnX2":6,
	"spawnY1":0,
	"spawnY2":15,
	"data":[
			[z, z, z, 8, 8, 8, 8, 8, 8, 8, z, z, z],
			[z, 8, 8, 8, 8, 8, 8, 8, a, 8, 8, 8, z],
			[8, 8, 8, 8, 9, 8, 8, 8, 8, 8, 8, 8, 8],
			[8, 8, 8, 8, 8, 8, 8, 8, 8, b, 8, 8, 8],
			[8, c, 8, 8, 8, 4, 4, 4, 8, 8, 8, 8, 8],
			[8, 8, 8, 4, 4, 4, 4, 4, 4, 4, 8, a, 8],
			[8, 8, 4, 4, 4, 4, 4, 4, 4, 4, 4, 8, 8],
			[8, 8, 4, 4, 4, 4, 4, 4, 4, 4, 4, 8, 8],
			[8, 8, 4, 4, 4, 4, 4, 4, 4, 4, 4, 8, 8],
			[8, 8, 4, 4, 4, 4, 4, 4, 4, 4, 4, 8, 8],
			[8, a, 8, 8, 4, 4, 4, 4, 4, 8, 8, c, 8],
			[8, 8, 8, 8, 8, 8, 4, 8, 8, 8, 8, 8, 8],
			[8, 8, 8, b, 8, 8, 8, 8, 8, 8, 8, 8, 8],
			[8, 8, 8, 8, 8, 8, 8, 8, 9, 8, 8, 8, 8],
			[z, z, 8, 8, a, 8, 8, 8, 8, 8, 8, z, z],
			[z, z, z, z, 8, z, 8, z, 8, z, z, z, z]
			]
}