{
	"name":"SkyLands",
	"desc":"Floating island with 3 choke-points.",
	"r":167,
	"g":220,
	"b":239,
	"spawnX1":8,
	"spawnX2":7,
	"spawnY1":1,
	"spawnY2":24,
	"data":[
			[z, z, z, z, z, 0, 0, 0, 0, 0, 0, z, z, z, z, z],
			[z, z, z, 0, 0, 0, 0, 0, 0, 0, 0, 0, 0, z, z, z],
			[z, z, 0, 0, 1, 1, 0, 0, 0, 0, 0, 1, 0, 0, z, z],
			[z, z, 0, 0, 7, 0, 1, 5, 0, 1, 1, 7, 0, 0, z, z],
			[z, z, z, 0, 0, 0, 0, 0, 0, 0, 0, 0, 0, z, z, z],
			[z, z, z, 0, z, z, z, 0, z, z, z, 0, z, z, z, z],
			[z, z, 0, 3, z, z, z, 0, z, z, z, 0, z, z, z, z],
			[z, z, 0, z, z, z, z, 5, 0, z, z, 0, z, z, z, z],
			[z, 0, 6, 0, z, z, z, z, 0, z, z, 0, 0, z, z, z],
			[0, 2, 0, 0, 0, z, z, 0, 0, z, z, z, 0, z, z, z],
			[0, 0, 7, 0, 0, z, z, 6, z, z, z, z, 3, 0, z, z],
			[0, 0, 5, 2, 0, z, z, 0, 0, z, z, z, z, 0, z, z],
			[z, 0, 0, 0, z, z, 0, 0, 0, 7, z, z, z, 0, z, z],
			[z, z, 0, z, z, z, 7, 0, 0, 0, z, z, 0, 0, 0, z],
			[z, z, 0, z, z, z, z, 0, 0, z, z, 0, 0, 5, 2, 0],
			[z, z, 0, 0, z, z, z, z, 6, z, z, 0, 0, 7, 0, 0],
			[z, z, z, 0, z, z, z, 0, 0, z, z, 0, 2, 0, 0, 0],
			[z, z, z, 3, 0, z, z, 0, z, z, z, z, 0, 6, 0, z],
			[z, z, z, z, 0, z, z, 0, 5, z, z, z, z, 0, z, z],
			[z, z, z, z, 0, z, z, z, 0, z, z, z, 3, 0, z, z],
			[z, z, z, z, 0, z, z, z, 0, z, z, z, 0, z, z, z],
			[z, z, z, 0, 0, 0, 0, 0, 0, 0, 0, 0, 0, z, z, z],
			[z, z, 0, 0, 7, 1, 1, 0, 5, 1, 0, 7, 0, 0, z, z],
			[z, z, 0, 0, 1, 0, 0, 0, 0, 0, 1, 1, 0, 0, z, z],
			[z, z, z, 0, 0, 0, 0, 0, 0, 0, 0, 0, 0, z, z, z],
			[z, z, z, z, z, 0, 0, 0, 0, 0, 0, z, z, z, z, z]
			]
}